++++ree++
++++rve++
++++ree++
+++ire+++
+++++e+++
+++++++++
+++++++++
+++++++++
+++++++++
